1111111111111111111111111111111
1000000000000000000100000000001
1000000000000000001E10010000001
10000000000000000000C0000010001
1000000000000000000000010000001
1000000000000000000100000000001
1000000000000000001C10010000001
1000000000000000000000000010001
10000000000000000000000000000P1
1111111111111111111111111111111