1111111111111
10C01C01CE1C1
1010100010101
1001010010001
1100001001001
1000001000001
100000000P001
1111111111111
